type octile
height 4
width 5
map
TTTTT
T.TTT
T...T
TTT.T